10
20
***#*****###********
***#****************
***#*************###
***#####*####**###**
*****************###
****#******#********
**********#@#*******
***********#********
###************#****
###****#************
